111111111111111111111111111111111111111111111
1C010000000000000010C100000000000000000000001
11C001000000000001C01000000000000000000000001
1C01C11C100000000001C000000000000000000000001
111111C1C111C1C1C01C0100000000000000000000001
10000C01C0001C1C1C010010000000000000000000001
1C110000101C000011C11010000000000000000000001
11C1111010C1001001010010000000000000000000101
10001C100C1C01C001010110000000000000000001001
101C000001C11C1001010010000000000000000001011
1C111111010C0010010C1010000000000000000001001
11C1000C000110100101001000000000000C1C0000101
10C001C001C10010010101C0000000000001C11111C01
1C1011101C01010101010010000000000001000000101
11001C00111C0C1CCC0110100000000000010C1110001
1101C10C1C0101CC1C01001C11C100000001010001111
1PE1C00111000C01C00C00C1C001000000010001000C1
111111111111111111111111111111111111111111111
