1111111
1CCCCC1
1CCCCC1
1CCECC1
1CCCCC1
1PCCCC1
1111111